NO ./assets/teapot1.xpm
SO ./assets/teapot2.xpm
WE ./assets/teapot3.xpm
EA ./assets/teapot4.xpm

F 255,255,255
C 255,255,255

111111111111111111111
1000000000000000000E1
111111111111111111111
