NO ./assets/teapot1.xpm
SO ./assets/teapot2.xpm
WE ./assets/teapot3.xpm
EA ./assets/teapot4.xpm

F 255,200,12
C 211,223,225

11111111111111
100000000000E1
10000000000001
11111111111111
