NO ./assets/wall04.xpm
SO ./assets/wall05.xpm
WE ./assets/wall06.xpm
EA ./assets/wall07.xpm

F 112,112,112
C 56,56,56

111111111111111111111
100000000000000000001
100011111000111111001
100000000000000000001
100000000E00000110001
100010000000000110001
100011000000000000001
100000000000000000001
111111111111111111111
